toimisto - агентство
lomake - анкета
valikoima - ассортимент
tanssiaiset - бал
juosta - бежать
huolestuttaa - беспокоить
kiittää - благодарить
läheinen - близкий
ruokalaji - блюдо
taistella - бороться
hallita, osata - владеть
vaikuttaa - влиять
kuljettaja - водитель
ajokortti - водительские права
sotilashenkilö - военный
ikä - возраст
astuttuaan sisään - войдя
toiseksi - во-вторых
ensiksikin - во-первых
vaikutelma - впечатление
haitallinen, vahingollinen - вредный
pääsy- - вступительный
jokainen, joka, kaikenlainen - всякий
kolmanneksi - в третьих
mistä on kyse - в чём дело
näyttää jltk - выглядеть
kutsua - вызвать
kasvaa - вырасти
lähettää - выслать
esiintyä - выступать
taata - гарантировать
pää-, tärkein - главный
kuuro - глухой
raja - граница
myöhempi, vastainen - дальнейший
serkku - двоюродная сестра
liikematka - деловая поездка
vaikuttaja(henkilö) - деятель
tutkintotodistus - диплом об образовании
tyytyväinen - доволен
virka, toimi - дожность
kotieläin - домашнее животное
tie, matka - дорога
matkalla - по дороге
